66666666666666
66666666666666
33333333333333
33333333333333
44444444444444
44444444444444
55555555555555
55555555555555