22222SSSS66666
2222SSSSSS6666
2222S5555S6666
222S555555S666
22S55555555S66
2S55  55  55S6
2S5555555555S6
2S5555555555S6
2S5S555555S5S6
2S55S5555S55S6
22S55SSSS55S66
222S555555S666
222SS5555SS666
    SS55SS
      SS