SSSSSSSSSSSSSS
SRRRRRRRRRRRRS
11111111111111
22222222222222
33333333333333
SS4444444444SS
00055555555000
00006666660000
00000777700000

     SSSS
SS1110000111SS
